map 88 18 spawn 9 5






                                                              F
               F                                             GGG
          F GGGG                                         F GGGDD    GG     F
      F GGGGDDDGGG  F                                    GGGDDDD          GGG
      GGDDDDDDDDDDGGGG          DDD     DDD       F   GGGDDDDDDDD    F               F G
 F GGGDDDDDDDDDDDDDDDGGGG  F                    GGGGGGDDDDDDDDDDGGGGGGG             GGGG
GGGGDDDDDDDDDDDDDDDDDDDDGGGGGGWWWWWWWWWWWWWWWGGGDDDDDDDDDDDDDDDDDDDDDDDGGGGGGWWWWGGGGDDD
DDDDDDDDDDDDDDDDDDDDLDDDDDDDDDWWWWWWWWWWWWWWWDDDDDDDDDDDDDCDDDDDDDDDDDDDDDDDDDWWDDDDDDDD
LDDDDDDDCCCDDDDDDDDDDDLLDDDDDDDDDWWWWWWWWWDDDDDDDDDDDDDDDCCCCDDDDDDDDDDDDLLLDDDDDDDDDDDD
LDDDDDDDDDCCCDCDDDDDDDDLDLDDDDDDDDDDDDDDDDDDDDDDDLDDDDDDDDDDDDDDDDDCDDDDLLDLDDDDDDDDDDDD
DDDDDDDDDDDCCCDDDDDDDDDDDLDDDCDDCDDDDDCCCDDDDDDLLLLLDDDDDDDDDDDDCCCCCDDDDDDDDDDDDCCDDCDD
DDDDDDDDDDDDDDDDDDDDDDDDDDDDDDDDDDDDDDDDDDDDDDDDDDDDDDDDDDCDDDDDDDDDDDDDDDDDDDDDDDDDDDDD
